###########
#211#74593#
#1#2#8###6#
#49122#976#
#3###898#5#
#5#2#7#8#1#
#4#7#T#9#7#
#661###7#3#
###1#2#3#2#
#374271729#
####B######